Team,Season,GP,Shots,SAT For,SAT Agst,SAT,SAT Tied,SAT Ahead,SAT Behind,SAT Close,USAT For,USAT Agst,USAT,USAT Tied,USAT Ahead,USAT Behind,USAT Close
Los Angeles Kings,20162017,82,2029,3971,3251,720,243,61,416,368,2927,2400,527,201,78,248,294
Boston Bruins,20162017,82,2102,3918,3239,679,211,77,391,361,2952,2380,572,169,156,247,331
Montréal Canadiens,20162017,82,2040,3940,3559,381,167,41,173,208,2837,2574,263,124,106,33,142
Washington Capitals,20162017,82,1941,3656,3400,256,196,-72,132,188,2695,2542,153,99,-12,66,104
Nashville Predators,20162017,82,2037,3801,3600,201,-22,-82,305,49,2815,2707,108,-24,-21,153,23
Carolina Hurricanes,20162017,82,1977,3830,3637,193,11,-44,226,70,2803,2755,48,-63,-16,127,-40
Tampa Bay Lightning,20162017,82,1897,3595,3419,176,121,-127,182,174,2693,2628,65,86,-78,57,112
San Jose Sharks,20162017,82,1931,3875,3704,171,66,-85,190,176,2805,2587,218,82,27,109,171
Philadelphia Flyers,20162017,82,1909,3755,3594,161,41,-98,218,177,2685,2544,141,71,-23,93,140
Calgary Flames,20162017,82,1844,3487,3414,73,70,-168,171,26,2547,2538,9,46,-77,40,18
Florida Panthers,20162017,82,1979,3513,3445,68,-57,-38,163,-2,2714,2698,16,-66,17,65,-13
Toronto Maple Leafs,20162017,82,2028,3937,3875,62,42,-220,240,44,2940,2968,-28,-5,-121,98,-19
Chicago Blackhawks,20162017,82,2015,3773,3711,62,-24,-151,237,29,2708,2715,-7,-65,-77,135,-32
Columbus Blue Jackets,20162017,82,2057,3720,3673,47,-11,-116,174,75,2775,2725,50,-24,-11,85,31
St. Louis Blues,20162017,82,1835,3414,3390,24,93,-205,136,101,2542,2495,47,50,-69,66,62
Pittsburgh Penguins,20162017,82,2162,3810,3789,21,-17,-43,81,-6,2874,2736,138,18,73,47,60
Dallas Stars,20162017,82,1970,3852,3839,13,98,-286,201,20,2815,2743,72,112,-179,139,69
Edmonton Oilers,20162017,82,2005,3663,3666,-3,-20,-189,206,-29,2739,2637,102,19,-32,115,56
Anaheim Ducks,20162017,82,1870,3506,3552,-46,15,-180,119,88,2647,2637,10,9,-55,56,68
Minnesota Wild,20162017,82,2032,3648,3745,-97,28,-248,123,30,2768,2780,-12,30,-125,83,56
Winnipeg Jets,20162017,82,1855,3399,3500,-101,-74,-88,61,-131,2551,2616,-65,-33,-49,17,-99
Colorado Avalanche,20162017,82,1811,3439,3647,-208,-124,-112,28,-245,2530,2789,-259,-92,-64,-103,-237
Ottawa Senators,20162017,82,1925,3595,3809,-214,-107,-193,86,-157,2616,2745,-129,-98,-54,23,-92
Detroit Red Wings,20162017,82,1827,3317,3564,-247,-42,-188,-17,-239,2543,2724,-181,-13,-104,-64,-187
Vancouver Canucks,20162017,82,1823,3399,3693,-294,-105,-266,77,-161,2486,2832,-346,-134,-171,-41,-189
New Jersey Devils,20162017,82,1789,3199,3495,-296,-109,-173,-14,-190,2471,2688,-217,-46,-110,-61,-131
New York Rangers,20162017,82,1895,3524,3824,-300,-145,-327,172,-151,2669,2800,-131,-50,-167,86,-40
New York Islanders,20162017,82,1995,3694,4036,-342,-171,-261,90,-231,2714,2936,-222,-125,-119,22,-130
Buffalo Sabres,20162017,82,1965,3486,3895,-409,-68,-352,11,-213,2675,2977,-302,-50,-236,-16,-187
Arizona Coyotes,20162017,82,1813,3412,4163,-751,-306,-344,-101,-429,2562,3202,-640,-228,-226,-186,-341
Carolina Hurricanes,20172018,82,2204,4259,3558,701,255,75,371,495,3113,2737,376,135,61,180,304
Calgary Flames,20172018,82,2146,4177,3630,547,198,57,292,285,3127,2738,389,160,84,145,224
Boston Bruins,20172018,82,2105,3915,3373,542,140,70,332,314,2948,2532,416,110,100,206,242
Chicago Blackhawks,20172018,82,2204,4198,3823,375,47,30,298,114,2948,2833,115,-37,25,127,-4
Pittsburgh Penguins,20172018,82,2231,3965,3619,346,190,-3,159,165,3015,2664,351,182,79,90,161
St. Louis Blues,20172018,82,2091,3896,3638,258,135,-17,140,120,2894,2596,298,149,46,103,136
Tampa Bay Lightning,20172018,82,2095,3880,3631,249,140,-64,173,255,2924,2757,167,105,-46,108,204
Columbus Blue Jackets,20172018,82,2269,4048,3814,234,120,-202,316,128,3105,2798,307,111,-48,244,159
Winnipeg Jets,20172018,82,2044,3812,3589,223,21,45,157,137,2845,2656,189,17,106,66,89
Nashville Predators,20172018,82,2038,3851,3629,222,196,-192,218,138,2854,2689,165,156,-123,132,101
Dallas Stars,20172018,82,1927,3726,3576,150,102,-153,201,140,2680,2564,116,81,-69,104,100
San Jose Sharks,20172018,82,2092,4071,3928,143,127,-148,164,172,2966,2773,193,145,-39,87,185
Vegas Golden Knights,20172018,82,2076,3881,3754,127,79,-97,145,73,2881,2802,79,53,-26,52,46
Edmonton Oilers,20172018,82,2180,4047,3953,94,53,-67,108,70,3036,2905,131,36,42,53,92
Montréal Canadiens,20172018,82,2077,3947,3862,85,26,-101,160,32,2827,2785,42,-9,-4,55,-15
Los Angeles Kings,20172018,82,1938,3690,3687,3,61,-176,118,89,2736,2768,-32,38,-110,40,22
Toronto Maple Leafs,20172018,82,2076,3965,3993,-28,-128,-156,256,-62,2926,3086,-160,-198,-91,129,-182
Philadelphia Flyers,20172018,82,2004,3659,3702,-43,-1,-174,132,-2,2734,2727,7,7,-50,50,29
Florida Panthers,20172018,82,2175,3802,3928,-126,-46,-266,186,-2,2965,2964,1,23,-143,121,86
Detroit Red Wings,20172018,82,1964,3575,3746,-171,-22,-173,24,-114,2747,2816,-69,12,-59,-22,-34
New Jersey Devils,20172018,82,2018,3586,3794,-208,-122,-154,68,-119,2769,2878,-109,-77,-40,8,-54
Anaheim Ducks,20172018,82,1940,3665,3881,-216,-90,-255,129,-213,2753,2926,-173,-61,-159,47,-143
Arizona Coyotes,20172018,82,1912,3774,4073,-299,-94,-237,32,-173,2729,3083,-354,-146,-190,-18,-216
Washington Capitals,20172018,82,1850,3609,3915,-306,-185,-264,143,-183,2654,2951,-297,-168,-163,34,-192
Vancouver Canucks,20172018,82,1925,3497,3833,-336,-101,-320,85,-140,2642,2898,-256,-67,-200,11,-104
Buffalo Sabres,20172018,82,1937,3379,3719,-340,-138,-258,56,-250,2600,2867,-267,-70,-157,-40,-196
Colorado Avalanche,20172018,82,1841,3491,3845,-354,-179,-203,28,-146,2530,2850,-320,-167,-137,-16,-155
New York Islanders,20172018,82,2004,3742,4138,-396,-93,-320,17,-240,2735,3104,-369,-89,-191,-89,-192
Minnesota Wild,20172018,82,1955,3434,3843,-409,-233,-242,66,-279,2603,2804,-201,-154,-89,42,-160
Ottawa Senators,20172018,82,1962,3684,4124,-440,-218,-252,30,-307,2717,2993,-276,-93,-109,-74,-157
New York Rangers,20172018,82,1987,3532,4159,-627,-240,-313,-74,-497,2687,3146,-459,-184,-177,-98,-376
Carolina Hurricanes,20182019,82,2232,4272,3523,749,292,-26,483,478,3216,2653,563,204,24,335,331
San Jose Sharks,20182019,82,2127,4137,3403,734,341,126,267,553,3020,2514,506,228,149,129,355
Vegas Golden Knights,20182019,82,2233,4184,3513,671,264,66,341,453,3068,2594,474,211,94,169,350
Montréal Canadiens,20182019,82,2301,4356,3694,662,234,148,280,385,3132,2736,396,124,121,151,214
Calgary Flames,20182019,82,2058,3942,3383,559,140,24,395,303,2898,2558,340,102,25,213,184
Boston Bruins,20182019,82,2125,3867,3420,447,186,37,224,311,2951,2552,399,153,93,153,282
Nashville Predators,20182019,82,2134,3902,3565,337,188,-69,218,237,2950,2678,272,131,31,110,173
Toronto Maple Leafs,20182019,82,2176,4396,4100,296,139,-108,265,257,3184,3178,6,9,-76,73,40
Tampa Bay Lightning,20182019,82,2102,3826,3590,236,111,-37,162,105,2882,2728,154,57,-3,100,36
St. Louis Blues,20182019,82,2049,3717,3501,216,13,-46,249,69,2785,2571,214,44,19,151,102
Minnesota Wild,20182019,82,2072,3805,3664,141,-85,-33,259,-59,2862,2658,204,-25,72,157,0
Columbus Blue Jackets,20182019,82,2120,3745,3716,29,103,-159,85,118,2907,2787,120,115,-39,44,151
Buffalo Sabres,20182019,82,2133,3754,3759,-5,-46,-86,127,-132,2913,2934,-21,-39,-34,52,-115
Colorado Avalanche,20182019,82,2045,3688,3708,-20,-1,-185,166,4,2723,2696,27,16,-81,92,39
Pittsburgh Penguins,20182019,82,2198,3919,3960,-41,101,-226,84,38,2957,2939,18,103,-116,31,64
Florida Panthers,20182019,82,2059,3639,3725,-86,30,-215,99,97,2789,2791,-2,33,-101,66,110
Chicago Blackhawks,20182019,82,2133,3833,3935,-102,34,-180,44,-7,2800,2985,-185,-14,-114,-57,-85
Washington Capitals,20182019,82,1953,3714,3859,-145,-71,-206,132,-92,2768,2884,-116,-56,-100,40,-67
Winnipeg Jets,20182019,82,1995,3692,3849,-157,-93,-193,129,-184,2760,2899,-139,-103,-100,64,-168
Arizona Coyotes,20182019,82,1982,3732,3907,-175,-77,-279,181,-160,2766,2836,-70,-32,-130,92,-65
Philadelphia Flyers,20182019,82,1977,3696,3930,-234,-128,-200,94,-173,2738,2858,-120,-82,-67,29,-83
Dallas Stars,20182019,82,1980,3632,3885,-253,-168,-222,137,-193,2664,2834,-170,-105,-142,77,-131
Los Angeles Kings,20182019,82,1874,3619,3908,-289,-80,-239,30,-186,2673,2937,-264,-82,-125,-57,-151
Edmonton Oilers,20182019,82,1906,3550,3849,-299,-150,-213,64,-196,2627,2875,-248,-129,-89,-30,-125
Vancouver Canucks,20182019,82,1872,3549,3863,-314,-149,-144,-21,-157,2648,2867,-219,-79,-60,-80,-102
New York Islanders,20182019,82,1891,3545,3864,-319,-16,-416,113,-166,2613,2801,-188,-12,-226,50,-118
Anaheim Ducks,20182019,82,1846,3596,3958,-362,-310,-182,130,-328,2673,2985,-312,-217,-105,10,-241
Detroit Red Wings,20182019,82,1885,3503,3933,-430,-83,-270,-77,-189,2604,3020,-416,-107,-195,-114,-218
New Jersey Devils,20182019,82,1931,3382,3833,-451,-124,-230,-97,-239,2628,2907,-279,-66,-119,-94,-147
New York Rangers,20182019,82,1869,3381,3958,-577,-321,-183,-73,-461,2564,2968,-404,-203,-115,-86,-311
Ottawa Senators,20182019,82,1956,3603,4421,-818,-274,-428,-116,-486,2710,3250,-540,-179,-234,-127,-304
Vegas Golden Knights,20192020,71,1951,3566,2945,621,185,140,296,295,2700,2210,490,150,150,190,251
Montréal Canadiens,20192020,71,1963,3656,3061,595,176,162,257,332,2682,2310,372,114,143,115,203
Carolina Hurricanes,20192020,68,1741,3222,2709,513,159,19,335,316,2435,2106,329,114,22,193,200
Los Angeles Kings,20192020,70,1849,3453,3052,401,75,-34,360,152,2617,2344,273,58,-19,234,97
Toronto Maple Leafs,20192020,70,1844,3466,3196,270,186,-56,140,184,2598,2463,135,114,-12,33,82
Tampa Bay Lightning,20192020,70,1676,3129,2863,266,29,89,148,118,2343,2202,141,-34,113,62,17
Colorado Avalanche,20192020,70,1779,3271,3066,205,162,-68,111,306,2401,2269,132,91,0,41,201
Washington Capitals,20192020,69,1672,3123,2930,193,31,-13,175,139,2341,2218,123,1,44,78,95
Nashville Predators,20192020,69,1775,3276,3155,121,34,-113,200,10,2491,2334,157,46,-8,119,53
Pittsburgh Penguins,20192020,69,1738,3035,2920,115,-36,-60,211,25,2318,2183,135,8,8,119,52
Philadelphia Flyers,20192020,69,1654,2977,2870,107,36,-62,133,120,2241,2172,69,-24,8,85,42
Boston Bruins,20192020,70,1694,3036,2940,96,24,-78,150,84,2315,2235,80,-11,10,81,49
St. Louis Blues,20192020,71,1737,2986,2894,92,78,-70,84,107,2296,2228,68,55,-30,43,53
San Jose Sharks,20192020,70,1645,3086,3021,65,81,-97,81,114,2267,2260,7,53,-29,-17,96
Calgary Flames,20192020,70,1742,3299,3256,43,17,-89,115,-2,2477,2506,-29,20,-62,13,-20
Florida Panthers,20192020,69,1755,3079,3108,-29,-45,-52,68,-65,2338,2332,6,-33,11,28,-57
Minnesota Wild,20192020,69,1658,3050,3098,-48,81,-213,84,29,2286,2312,-26,77,-96,-7,43
Dallas Stars,20192020,69,1625,3014,3081,-67,56,-156,33,-41,2211,2270,-59,8,-64,-3,-51
Buffalo Sabres,20192020,69,1585,2852,2953,-101,-4,-142,45,7,2199,2322,-123,14,-74,-63,4
Columbus Blue Jackets,20192020,70,1841,3133,3242,-109,-27,-171,89,-50,2427,2339,88,51,-59,96,83
Winnipeg Jets,20192020,71,1714,3157,3347,-190,-130,-223,163,-156,2368,2610,-242,-132,-167,57,-160
Chicago Blackhawks,20192020,70,1746,3155,3356,-201,-154,-167,120,-198,2321,2515,-194,-116,-112,34,-167
Vancouver Canucks,20192020,69,1652,3060,3261,-201,-81,-246,126,-64,2313,2400,-87,-59,-96,68,-16
Arizona Coyotes,20192020,70,1761,3167,3382,-215,-118,-158,61,-160,2407,2574,-167,-78,-81,-8,-102
Anaheim Ducks,20192020,71,1674,3143,3364,-221,-68,-194,41,-79,2413,2580,-167,-45,-134,12,-66
Ottawa Senators,20192020,71,1707,3211,3444,-233,-149,-115,31,-171,2425,2571,-146,-114,-29,-3,-97
Edmonton Oilers,20192020,71,1674,3037,3310,-273,-27,-214,-32,-162,2295,2457,-162,-29,-118,-15,-132
New York Rangers,20192020,70,1685,2973,3391,-418,-176,-251,9,-285,2289,2533,-244,-95,-129,-20,-170
New York Islanders,20192020,68,1601,2971,3418,-447,-131,-283,-33,-240,2179,2487,-308,-72,-148,-88,-165
Detroit Red Wings,20192020,71,1503,2697,3166,-469,-146,-217,-106,-345,2070,2432,-362,-92,-146,-124,-235
New Jersey Devils,20192020,69,1589,2847,3330,-483,-120,-201,-162,-322,2184,2474,-290,-41,-101,-148,-184
Colorado Avalanche,20202021,56,1480,2829,1963,866,292,358,216,539,2059,1464,595,163,301,131,350
Montréal Canadiens,20202021,56,1414,2704,2256,448,183,119,146,271,1958,1690,268,134,84,50,185
Boston Bruins,20202021,56,1461,2541,2149,392,195,53,144,272,1995,1626,369,171,89,109,247
Carolina Hurricanes,20202021,56,1408,2609,2249,360,195,112,53,251,1969,1727,242,107,124,11,148
Vegas Golden Knights,20202021,56,1404,2713,2369,344,122,90,132,205,1975,1701,274,105,86,83,167
Florida Panthers,20202021,56,1462,2455,2134,321,145,-3,179,222,1922,1651,271,138,31,102,205
Calgary Flames,20202021,56,1297,2443,2167,276,9,55,212,101,1844,1666,178,8,60,110,71
Dallas Stars,20202021,56,1350,2503,2227,276,122,-25,179,204,1844,1660,184,73,24,87,131
Tampa Bay Lightning,20202021,56,1315,2321,2105,216,38,64,115,175,1781,1618,163,17,92,55,118
Philadelphia Flyers,20202021,56,1294,2440,2253,187,-7,-7,201,43,1821,1718,103,-8,9,102,8
Toronto Maple Leafs,20202021,56,1364,2455,2357,98,81,-63,80,151,1884,1762,122,56,40,26,106
Washington Capitals,20202021,56,1280,2375,2327,48,-22,17,53,87,1794,1780,14,-13,42,-15,38
New Jersey Devils,20202021,56,1300,2419,2372,47,45,-93,95,-2,1835,1870,-35,13,-85,37,-44
Pittsburgh Penguins,20202021,56,1346,2347,2300,47,50,-36,33,51,1798,1757,41,27,-15,29,32
Nashville Predators,20202021,56,1321,2375,2380,-5,-29,-50,74,-66,1856,1800,56,-1,-3,60,-21
Anaheim Ducks,20202021,56,1214,2380,2493,-113,-132,-29,48,-136,1742,1888,-146,-97,-28,-21,-125
Arizona Coyotes,20202021,56,1208,2318,2443,-125,-33,-124,32,-129,1737,1835,-98,-26,-76,4,-102
Edmonton Oilers,20202021,56,1295,2384,2519,-135,-45,-174,84,-59,1777,1873,-96,-46,-79,29,-49
New York Islanders,20202021,56,1294,2301,2438,-137,-54,5,-88,-108,1742,1786,-44,-31,57,-70,-48
Ottawa Senators,20202021,56,1304,2457,2601,-144,-95,-80,31,-112,1861,1951,-90,-57,-27,-6,-76
Winnipeg Jets,20202021,56,1279,2326,2489,-163,-128,-101,66,-173,1743,1866,-123,-103,-36,16,-129
St. Louis Blues,20202021,56,1238,2224,2425,-201,13,-164,-50,-66,1640,1803,-163,0,-99,-64,-75
Los Angeles Kings,20202021,56,1227,2227,2429,-202,1,-144,-59,-89,1706,1838,-132,24,-59,-97,-34
San Jose Sharks,20202021,56,1289,2357,2562,-205,-117,-52,-36,-159,1784,1911,-127,-89,-6,-32,-113
New York Rangers,20202021,56,1234,2172,2421,-249,-101,-164,17,-134,1672,1824,-152,-69,-67,-15,-64
Buffalo Sabres,20202021,56,1297,2271,2604,-333,-106,-124,-103,-212,1783,2077,-294,-91,-82,-121,-171
Columbus Blue Jackets,20202021,56,1339,2327,2680,-353,-142,-150,-61,-324,1791,2018,-227,-91,-71,-65,-215
Minnesota Wild,20202021,56,1213,2182,2537,-355,-143,-139,-73,-159,1686,1882,-196,-79,-60,-57,-64
Vancouver Canucks,20202021,56,1292,2313,2685,-372,-2,-199,-171,-171,1754,2006,-252,11,-113,-150,-100
Chicago Blackhawks,20202021,56,1249,2216,2613,-397,-141,-155,-101,-211,1605,1963,-358,-113,-103,-142,-181
Detroit Red Wings,20202021,56,1196,2090,2508,-418,-191,-68,-160,-254,1597,1926,-329,-131,-36,-163,-185
